12:12
 0  0  0  0  0 17  0  0  0  0  0  0
 0  0  0  0  0 17  0 17  0  0  0  0
 0  0  0  0  0 17  0 17  0  0  0  0
 0  0  0  0  0 17  0 17  0  0  0  0
17 17  0 17 17 17  0 17  0  0  0  0
 0  0  0  0  0  0  0 17  0  0  0  0
 0 17 17 17 17 17 17 17  0 17 17 17
 0 17  0  0  0  0  0  0  0  0  0  0
 0 17  0  0  0  0  0 17 17 17 17  0
 0 17  0  0  0 17 17 17  0  0  0  0
 0 17 17 17  0 17  0  0  0  0  0  0
 0  0  0 17 48 17  0  0  0  0  0  0




